12
40
1111111111111111111111111111111111111111
1000000000000000000000000000000000000001
1000006000000070000000000000000000000001
1000000000000000000000000000000000000001
1111111110000000000000000000000010000001
1000000000010000000000000000001010000001
1000000000001000000000000000010010000001
1000000000000101000000000000100010000001
1000000000000000111000600001000010000001
1003000000000000000000111100000010000001
1000000000000000000000000000006010200001
1111111111111111111111111111111111111111